"Agency","Component","Fiscal Year","Number Affirmed on Appeal","Number Partially Affirmed & Partially Reversed/Remanded on Appeal","Number Completely Reversed/Remanded on Appeal","Number of Appeals Closed for Other Reasons","Total"
"Commodity Futures Trading Commission","Agency Overall","2018","1","0","0","0","1"
"Merit Systems Protection Board","Agency Overall","2018","3","4","0","1","8"
"United States African Development Foundation","Agency Overall","2018","0","0","0","0","0"
"Securities and Exchange Commission","Agency Overall","2018","514","26","87","10","637"
"Department of Homeland Security","Agency Overall","2018","1420","1463","1606","838","5327"
"National Indian Gaming Commission","Agency Overall","2018","0","0","0","0","0"
"Office of Government Ethics","Agency Overall","2018","4","0","1","0","5"
"National Commission on Military, National, and Public Service","Agency Overall","2018","1","0","0","0","1"
"National Mediation Board","Agency Overall","2018","0","0","0","0","0"
"U.S. Agency for Global Media","Agency Overall","2018","1","0","2","0","3"
"Office of Navajo and Hopi Indian Relocation","Agency Overall","2018","0","0","0","0","0"
"Consumer Financial Protection Bureau","Agency Overall","2018","15","7","28","3","53"
"Department of Agriculture","Agency Overall","2018","40","99","13","98","250"
"Court Services and Offender Supervision Agency","Agency Overall","2018","0","0","0","0","0"
"General Services Administration","Agency Overall","2018","30","5","2","4","41"
"Federal Mediation and Conciliation Service","Agency Overall","2018","2","0","0","0","2"
"Harry S. Truman Scholarship Foundation","Agency Overall","2018","0","0","0","0","0"
"Peace Corps","Agency Overall","2018","2","1","3","1","7"
"Department of Education","Agency Overall","2018","12","14","11","16","53"
"Office of National Drug Control Policy","Agency Overall","2018","0","0","0","0","0"
"Department of Housing and Urban Development","Agency Overall","2018","34","5","5","6","50"
"Armed Forces Retirement Home","Agency Overall","2018","0","0","0","0","0"
"National Capital Planning Commission","Agency Overall","2018","0","0","0","0","0"
"Federal Communications Commission","Agency Overall","2018","0","0","4","31","35"
"Legal Services Corporation","Agency Overall","2018","0","0","0","0","0"
"United States International Trade Commission","Agency Overall","2018","1","0","1","0","2"
"Inter-American Foundation","Agency Overall","2018","0","0","0","0","0"
"Federal Retirement Thrift Investment Board","Agency Overall","2018","1","0","0","0","1"
"Department of the Treasury","Agency Overall","2018","141","12","5","2","160"
"Office of Personnel Management","Agency Overall","2018","22","5","14","21","62"
"Gulf Coast Ecosystem Restoration Council","Agency Overall","2018","0","0","0","0","0"
"James Madison Memorial Fellowship Foundation","Agency Overall","2018","0","0","0","0","0"
"Office of the Director of National Intelligence","Agency Overall","2018","0","0","0","11","11"
"United States Trade and Development Agency","Agency Overall","2018","0","0","0","0","0"
"Council of the Inspectors General on Integrity and Efficiency","Agency Overall","2018","0","0","0","0","0"
"Appraisal Subcommittee","Agency Overall","2018","0","0","0","0","0"
"U.S. Railroad Retirement Board","Agency Overall","2018","0","0","0","0","0"
"Committee for Purchase from People Who Are Blind or Severely Disabled","Agency Overall","2018","0","0","0","0","0"
"Federal Deposit Insurance Corporation","Agency Overall","2018","7","1","1","1","10"
"National Railroad Passenger Corporation","Agency Overall","2018","0","0","2","3","5"
"Department of Health and Human Services","Agency Overall","2018","19","8","5","138","170"
"U.S. Department of State","Agency Overall","2018","118","63","27","20","228"
"Occupational Safety and Health Review Commission","Agency Overall","2018","0","0","0","1","1"
"Office of the United States Trade Representative","Agency Overall","2018","2","1","0","1","4"
"Federal Reserve System","Agency Overall","2018","4","0","0","1","5"
"U.S. Agency for International Development","Agency Overall","2018","7","5","1","3","16"
"U.S. Election Assistance Commission","Agency Overall","2018","0","0","0","0","0"
"Small Business Administration","Agency Overall","2018","11","4","6","7","28"
"Corporation for National and Community Service (operating as AmeriCorps)","Agency Overall","2018","1","0","0","0","1"
"Presidio Trust","Agency Overall","2018","0","0","0","0","0"
"Office of Science and Technology Policy","Agency Overall","2018","4","1","1","2","8"
"Farm Credit Administration","Agency Overall","2018","0","0","0","0","0"
"Federal Housing Finance Agency","Agency Overall","2018","3","0","1","1","5"
"Department of Commerce","Agency Overall","2018","22","18","7","19","66"
"United States Institute of Peace","Agency Overall","2018","0","0","0","0","0"
"U.S. Nuclear Waste Technical Review Board","Agency Overall","2018","0","0","0","0","0"
"Nuclear Regulatory Commission","Agency Overall","2018","79","3","9","29","120"
"Overseas Private Investment Corporation","Agency Overall","2018","0","0","0","0","0"
"Selective Service System","Agency Overall","2018","0","0","0","0","0"
"Export-Import Bank of the U.S.","Agency Overall","2018","1","1","1","0","3"
"United States International Boundary and Water Commission","Agency Overall","2018","0","1","0","0","1"
"Department of Justice","Agency Overall","2018","2615","183","362","862","4022"
"Morris K. Udall and Stewart L. Udall Foundation","Agency Overall","2018","0","0","0","0","0"
"United States Access Board","Agency Overall","2018","0","0","0","0","0"
"U.S. Interagency Council on Homelessness","Agency Overall","2018","0","0","0","0","0"
"Office of Management and Budget","Agency Overall","2018","0","0","0","0","0"
"Federal Financial Institutions Examination Council","Agency Overall","2018","0","0","0","0","0"
"Privacy and Civil Liberties Oversight Board","Agency Overall","2018","0","0","0","0","0"
"Pension Benefit Guaranty Corporation","Agency Overall","2018","9","0","0","5","14"
"Central Intelligence Agency","Agency Overall","2018","74","14","3","128","219"
"Defense Nuclear Facilities Safety Board","Agency Overall","2018","0","1","0","0","1"
"Advisory Council on Historic Preservation","Agency Overall","2018","0","0","0","0","0"
"National Council on Disability","Agency Overall","2018","0","0","0","0","0"
"Postal Regulatory Commission","Agency Overall","2018","0","1","0","0","1"
"Farm Credit System Insurance Corporation","Agency Overall","2018","0","0","0","0","0"
"Neighborhood Reinvestment Corporation","Agency Overall","2018","0","0","0","0","0"
"Federal Maritime Commission","Agency Overall","2018","1","0","0","0","1"
"National Labor Relations Board","Agency Overall","2018","5","3","2","3","13"
"National Aeronautics and Space Administration","Agency Overall","2018","4","4","3","4","15"
"Department of Veterans Affairs","Agency Overall","2018","86","16","85","155","342"
"Commission of Fine Arts","Agency Overall","2018","0","0","0","0","0"
"Department of Energy","Agency Overall","2018","14","14","4","24","56"
"Environmental Protection Agency","Agency Overall","2018","33","19","41","94","187"
"National Endowment for the Humanities","Agency Overall","2018","2","0","0","0","2"
"U.S. Commission on Civil Rights","Agency Overall","2018","0","0","0","0","0"
"Department of Labor","Agency Overall","2018","11","12","47","201","271"
"Federal Labor Relations Authority","Agency Overall","2018","0","0","0","0","0"
"National Science Foundation","Agency Overall","2018","1","3","0","0","4"
"Federal Energy Regulatory Commission","Agency Overall","2018","0","2","2","2","6"
"Federal Trade Commission","Agency Overall","2018","18","1","3","2","24"
"Office of the Special Inspector General for Afghanistan Reconstruction","Agency Overall","2018","0","0","0","0","0"
"Marine Mammal Commission","Agency Overall","2018","0","0","0","0","0"
"Office of Special Counsel","Agency Overall","2018","5","1","5","2","13"
"United States Postal Service","Agency Overall","2018","76","31","35","28","170"
"Equal Employment Opportunity Commission","Agency Overall","2018","113","28","34","151","326"
"Chemical Safety and Hazard Investigation Board","Agency Overall","2018","2","0","2","0","4"
"Department of the Interior","Agency Overall","2018","26","13","49","153","241"
"Federal Mine Safety and Health Review Commission","Agency Overall","2018","0","0","0","0","0"
"Denali Commission","Agency Overall","2018","0","0","0","0","0"
"National Archives and Records Administration","Agency Overall","2018","37","14","10","23","84"
"United States Copyright Office","Agency Overall","2018","2","0","0","0","2"
"Social Security Administration","Agency Overall","2018","79","81","127","190","477"
"National Transportation Safety Board","Agency Overall","2018","5","3","1","11","20"
"Administrative Conference of the United States","Agency Overall","2018","0","0","0","0","0"
"National Credit Union Administration","Agency Overall","2018","2","0","0","0","2"
"Surface Transportation Board","Agency Overall","2018","2","0","0","0","2"
"Institute of Museum and Library Services","Agency Overall","2018","0","0","0","0","0"
"Tennessee Valley Authority","Agency Overall","2018","7","1","0","0","8"
"Council on Environmental Quality","Agency Overall","2018","1","0","2","0","3"
"Department of Transportation","Agency Overall","2018","23","19","15","33","90"
"National Endowment for the Arts","Agency Overall","2018","0","0","0","0","0"
"Federal Open Market Committee","Agency Overall","2018","0","1","0","0","1"
"Consumer Product Safety Commission","Agency Overall","2018","6","4","2","0","12"
"Department of Defense","Agency Overall","2018","397","113","269","368","1147"
"Millennium Challenge Corporation","Agency Overall","2018","0","0","0","0","0"
"American Battle Monuments Commission","Agency Overall","2018","0","0","0","0","0"
"Social Security Advisory Board","Agency Overall","2018","0","0","0","0","0"
"Federal Election Commission","Agency Overall","2018","3","0","0","0","3"
"All agencies","Agency Overall","2018","6181","2329","2946","3707","15163"