"Agency","Component","Fiscal Year","Number Affirmed on Appeal","Number Partially Affirmed & Partially Reversed/Remanded on Appeal","Number Completely Reversed/Remanded on Appeal","Number of Appeals Closed for Other Reasons","Total"
"Office of Science and Technology Policy","Agency Overall","2013","3","0","1","1","5"
"Department of Justice","Agency Overall","2013","2050","125","359","864","3398"
"Court Services and Offender Supervision Agency","Agency Overall","2013","0","0","0","0","0"
"Chemical Safety and Hazard Investigation Board","Agency Overall","2013","0","0","0","0","0"
"National Endowment for the Arts","Agency Overall","2013","0","0","0","1","1"
"Federal Communications Commission","Agency Overall","2013","8","0","0","8","16"
"United States Trade and Development Agency","Agency Overall","2013","1","0","0","0","1"
"National Labor Relations Board","Agency Overall","2013","14","11","1","0","26"
"Federal Open Market Committee","Agency Overall","2013","0","0","0","0","0"
"National Capital Planning Commission","Agency Overall","2013","0","0","0","0","0"
"Postal Regulatory Commission","Agency Overall","2013","0","0","0","0","0"
"American Battle Monuments Commission","Agency Overall","2013","0","0","0","0","0"
"Federal Labor Relations Authority","Agency Overall","2013","3","0","0","0","3"
"Selective Service System","Agency Overall","2013","0","0","0","0","0"
"Peace Corps","Agency Overall","2013","2","2","0","2","6"
"U.S. Commission on Civil Rights","Agency Overall","2013","0","0","0","0","0"
"Department of Agriculture","Agency Overall","2013","64","58","29","45","196"
"National Credit Union Administration","Agency Overall","2013","3","2","0","0","5"
"Federal Mine Safety and Health Review Commission","Agency Overall","2013","0","1","0","0","1"
"Pension Benefit Guaranty Corporation","Agency Overall","2013","2","1","0","0","3"
"Environmental Protection Agency","Agency Overall","2013","160","0","0","24","184"
"Consumer Product Safety Commission","Agency Overall","2013","8","4","0","0","12"
"Federal Reserve System","Agency Overall","2013","20","10","0","7","37"
"Council of the Inspectors General on Integrity and Efficiency","Agency Overall","2013","1","1","0","1","3"
"Overseas Private Investment Corporation","Agency Overall","2013","0","0","1","0","1"
"Department of Commerce","Agency Overall","2013","36","22","6","12","76"
"U.S. Railroad Retirement Board","Agency Overall","2013","2","0","0","0","2"
"United States International Trade Commission","Agency Overall","2013","0","0","0","0","0"
"Securities and Exchange Commission","Agency Overall","2013","88","12","22","27","149"
"Department of Transportation","Agency Overall","2013","37","26","50","17","130"
"Millennium Challenge Corporation","Agency Overall","2013","0","1","0","0","1"
"Social Security Administration","Agency Overall","2013","178","54","227","0","459"
"Department of Health and Human Services","Agency Overall","2013","67","19","27","168","281"
"Armed Forces Retirement Home","Agency Overall","2013","0","0","0","0","0"
"Federal Housing Finance Agency","Agency Overall","2013","5","6","0","2","13"
"Occupational Safety and Health Review Commission","Agency Overall","2013","0","0","0","0","0"
"Department of the Interior","Agency Overall","2013","43","7","41","86","177"
"United States Postal Service","Agency Overall","2013","49","21","39","22","131"
"Defense Nuclear Facilities Safety Board","Agency Overall","2013","0","0","0","0","0"
"United States International Boundary and Water Commission","Agency Overall","2013","0","0","0","0","0"
"Federal Financial Institutions Examination Council","Agency Overall","2013","0","0","0","0","0"
"Institute of Museum and Library Services","Agency Overall","2013","1","0","0","0","1"
"Equal Employment Opportunity Commission","Agency Overall","2013","159","76","56","0","291"
"General Services Administration","Agency Overall","2013","13","8","0","2","23"
"Recovery Accountability and Transparency Board","Agency Overall","2013","0","1","0","0","1"
"Department of Homeland Security","Agency Overall","2013","882","950","693","521","3046"
"Office of Government Ethics","Agency Overall","2013","1","0","1","0","2"
"National Archives and Records Administration","Agency Overall","2013","39","13","5","6","63"
"Legal Services Corporation","Agency Overall","2013","1","0","0","0","1"
"National Mediation Board","Agency Overall","2013","0","0","0","0","0"
"Office of the Director of National Intelligence","Agency Overall","2013","11","0","1","11","23"
"Merit Systems Protection Board","Agency Overall","2013","6","4","2","6","18"
"Office of National Drug Control Policy","Agency Overall","2013","0","0","0","0","0"
"Department of Housing and Urban Development","Agency Overall","2013","30","7","10","0","47"
"National Aeronautics and Space Administration","Agency Overall","2013","8","5","2","1","16"
"Federal Mediation and Conciliation Service","Agency Overall","2013","1","0","0","0","1"
"Federal Retirement Thrift Investment Board","Agency Overall","2013","0","1","0","0","1"
"U.S. Agency for International Development","Agency Overall","2013","8","8","6","3","25"
"Department of the Treasury","Agency Overall","2013","293","34","7","12","346"
"Federal Maritime Commission","Agency Overall","2013","0","0","0","0","0"
"Corporation for National and Community Service (operating as AmeriCorps)","Agency Overall","2013","0","0","0","1","1"
"Department of Labor","Agency Overall","2013","11","55","85","242","393"
"Federal Deposit Insurance Corporation","Agency Overall","2013","23","8","1","2","34"
"National Endowment for the Humanities","Agency Overall","2013","0","0","0","0","0"
"Nuclear Regulatory Commission","Agency Overall","2013","5","2","3","5","15"
"National Transportation Safety Board","Agency Overall","2013","0","2","0","2","4"
"Federal Energy Regulatory Commission","Agency Overall","2013","6","4","1","1","12"
"Federal Trade Commission","Agency Overall","2013","4","5","5","12","26"
"Office of Special Counsel","Agency Overall","2013","6","1","1","0","8"
"Committee for Purchase from People Who Are Blind or Severely Disabled","Agency Overall","2013","0","0","0","0","0"
"Consumer Financial Protection Bureau","Agency Overall","2013","12","3","3","2","20"
"Farm Credit Administration","Agency Overall","2013","1","0","0","0","1"
"Small Business Administration","Agency Overall","2013","4","3","5","0","12"
"Office of Personnel Management","Agency Overall","2013","26","6","5","2","39"
"Farm Credit System Insurance Corporation","Agency Overall","2013","0","0","0","0","0"
"National Science Foundation","Agency Overall","2013","3","0","1","0","4"
"Department of Defense","Agency Overall","2013","428","169","99","449","1145"
"United States African Development Foundation","Agency Overall","2013","0","0","0","0","0"
"Surface Transportation Board","Agency Overall","2013","0","0","0","0","0"
"Central Intelligence Agency","Agency Overall","2013","223","29","4","104","360"
"U.S. Agency for Global Media","Agency Overall","2013","2","0","0","0","2"
"Inter-American Foundation","Agency Overall","2013","0","0","0","0","0"
"United States Copyright Office","Agency Overall","2013","0","0","0","0","0"
"U.S. Department of State","Agency Overall","2013","208","86","27","49","370"
"Department of Veterans Affairs","Agency Overall","2013","49","24","5","165","243"
"Office of Management and Budget","Agency Overall","2013","4","0","0","0","4"
"National Indian Gaming Commission","Agency Overall","2013","1","1","1","0","3"
"Office of Navajo and Hopi Indian Relocation","Agency Overall","2013","0","0","0","0","0"
"Council on Environmental Quality","Agency Overall","2013","1","0","0","0","1"
"Office of the United States Trade Representative","Agency Overall","2013","0","2","0","0","2"
"Tennessee Valley Authority","Agency Overall","2013","6","1","0","2","9"
"Commodity Futures Trading Commission","Agency Overall","2013","4","0","1","1","6"
"National Railroad Passenger Corporation","Agency Overall","2013","0","1","1","0","2"
"Export-Import Bank of the U.S.","Agency Overall","2013","1","1","0","0","2"
"Department of Energy","Agency Overall","2013","42","15","6","17","80"
"Administrative Conference of the United States","Agency Overall","2013","0","0","0","0","0"
"Department of Education","Agency Overall","2013","10","4","2","4","20"
"Office of the Special Inspector General for Afghanistan Reconstruction","Agency Overall","2013","0","0","0","1","1"
"Federal Election Commission","Agency Overall","2013","0","0","0","1","1"
"All agencies","Agency Overall","2013","5377","1912","1842","2911","12042"