"Agency","Component","Fiscal Year","Number Affirmed on Appeal","Number Partially Affirmed & Partially Reversed/Remanded on Appeal","Number Completely Reversed/Remanded on Appeal","Number of Appeals Closed for Other Reasons","Total"
"Department of Health and Human Services","Agency Overall","2011","110","14","20","175","319"
"U.S. Agency for Global Media","Agency Overall","2011","4","1","0","1","6"
"United States Postal Service","Agency Overall","2011","40","18","30","32","120"
"Department of the Treasury","Agency Overall","2011","273","33","23","25","354"
"Tennessee Valley Authority","Agency Overall","2011","1","1","0","2","4"
"Office of the United States Trade Representative","Agency Overall","2011","2","3","0","0","5"
"Council on Environmental Quality","Agency Overall","2011","0","0","0","0","0"
"Committee for Purchase from People Who Are Blind or Severely Disabled","Agency Overall","2011","0","0","0","0","0"
"Department of Housing and Urban Development","Agency Overall","2011","11","8","11","7","37"
"Federal Maritime Commission","Agency Overall","2011","0","1","0","0","1"
"Pension Benefit Guaranty Corporation","Agency Overall","2011","3","0","1","1","5"
"Special Inspector General for Iraq Reconstruction","Agency Overall","2011","0","0","0","0","0"
"U.S. Railroad Retirement Board","Agency Overall","2011","3","1","0","0","4"
"Selective Service System","Agency Overall","2011","0","0","0","0","0"
"Export-Import Bank of the U.S.","Agency Overall","2011","0","0","0","0","0"
"U.S. Department of State","Agency Overall","2011","104","227","22","28","381"
"Central Intelligence Agency","Agency Overall","2011","167","19","3","66","255"
"Federal Communications Commission","Agency Overall","2011","10","2","0","5","17"
"National Transportation Safety Board","Agency Overall","2011","3","1","0","6","10"
"United States Trade and Development Agency","Agency Overall","2011","0","0","1","1","2"
"Corporation for National and Community Service (operating as AmeriCorps)","Agency Overall","2011","0","0","1","0","1"
"Department of Transportation","Agency Overall","2011","45","29","49","46","169"
"Farm Credit System Insurance Corporation","Agency Overall","2011","0","0","0","0","0"
"Department of Homeland Security","Agency Overall","2011","618","638","440","237","1933"
"Office of National Drug Control Policy","Agency Overall","2011","1","0","0","0","1"
"Defense Nuclear Facilities Safety Board","Agency Overall","2011","0","0","0","0","0"
"Office of Science and Technology Policy","Agency Overall","2011","5","0","0","1","6"
"United States International Trade Commission","Agency Overall","2011","0","1","0","0","1"
"Equal Employment Opportunity Commission","Agency Overall","2011","350","117","62","73","602"
"Federal Housing Finance Agency","Agency Overall","2011","9","3","0","0","12"
"National Aeronautics and Space Administration","Agency Overall","2011","10","6","3","4","23"
"Federal Retirement Thrift Investment Board","Agency Overall","2011","0","0","0","0","0"
"Overseas Private Investment Corporation","Agency Overall","2011","0","1","1","0","2"
"Federal Financial Institutions Examination Council","Agency Overall","2011","0","0","0","0","0"
"Department of Education","Agency Overall","2011","3","0","5","7","15"
"Department of Veterans Affairs","Agency Overall","2011","36","39","22","132","229"
"National Railroad Passenger Corporation","Agency Overall","2011","3","0","0","4","7"
"Institute of Museum and Library Services","Agency Overall","2011","0","0","0","0","0"
"Surface Transportation Board","Agency Overall","2011","0","0","0","0","0"
"Occupational Safety and Health Review Commission","Agency Overall","2011","0","0","0","0","0"
"Securities and Exchange Commission","Agency Overall","2011","86","16","36","24","162"
"Department of Justice","Agency Overall","2011","1965","185","429","783","3362"
"U.S. Commission on Civil Rights","Agency Overall","2011","0","0","0","0","0"
"Armed Forces Retirement Home","Agency Overall","2011","1","0","0","0","1"
"Council of the Inspectors General on Integrity and Efficiency","Agency Overall","2011","0","0","0","0","0"
"Office of Management and Budget","Agency Overall","2011","8","1","0","1","10"
"U.S. Agency for International Development","Agency Overall","2011","0","1","0","2","3"
"Federal Energy Regulatory Commission","Agency Overall","2011","4","2","4","4","14"
"Court Services and Offender Supervision Agency","Agency Overall","2011","0","0","0","0","0"
"National Capital Planning Commission","Agency Overall","2011","0","0","1","0","1"
"Legal Services Corporation","Agency Overall","2011","1","1","0","0","2"
"Office of Special Counsel","Agency Overall","2011","4","3","0","0","7"
"Merit Systems Protection Board","Agency Overall","2011","3","4","1","0","8"
"National Endowment for the Arts","Agency Overall","2011","1","1","0","2","4"
"Federal Mediation and Conciliation Service","Agency Overall","2011","0","0","0","0","0"
"Millennium Challenge Corporation","Agency Overall","2011","0","1","0","0","1"
"Department of Defense","Agency Overall","2011","248","83","105","471","907"
"Inter-American Foundation","Agency Overall","2011","0","0","0","0","0"
"Farm Credit Administration","Agency Overall","2011","0","0","0","0","0"
"American Battle Monuments Commission","Agency Overall","2011","0","0","0","0","0"
"National Credit Union Administration","Agency Overall","2011","7","3","0","0","10"
"Federal Labor Relations Authority","Agency Overall","2011","5","0","2","1","8"
"National Archives and Records Administration","Agency Overall","2011","35","9","11","9","64"
"Department of Energy","Agency Overall","2011","34","7","10","19","70"
"Office of Personnel Management","Agency Overall","2011","12","7","5","2","26"
"Department of Commerce","Agency Overall","2011","26","26","24","32","108"
"Department of Agriculture","Agency Overall","2011","63","51","18","60","192"
"Federal Reserve System","Agency Overall","2011","12","2","0","3","17"
"Office of Government Ethics","Agency Overall","2011","1","2","0","0","3"
"Small Business Administration","Agency Overall","2011","6","9","0","7","22"
"General Services Administration","Agency Overall","2011","19","0","0","2","21"
"National Mediation Board","Agency Overall","2011","0","0","0","0","0"
"Federal Election Commission","Agency Overall","2011","1","2","0","0","3"
"Peace Corps","Agency Overall","2011","7","2","0","2","11"
"Office of Navajo and Hopi Indian Relocation","Agency Overall","2011","0","0","0","0","0"
"National Indian Gaming Commission","Agency Overall","2011","1","0","0","1","2"
"Administrative Conference of the United States","Agency Overall","2011","0","0","0","0","0"
"Federal Mine Safety and Health Review Commission","Agency Overall","2011","0","0","0","0","0"
"Commodity Futures Trading Commission","Agency Overall","2011","3","0","0","0","3"
"National Labor Relations Board","Agency Overall","2011","40","6","2","10","58"
"Federal Deposit Insurance Corporation","Agency Overall","2011","26","7","3","2","38"
"Chemical Safety and Hazard Investigation Board","Agency Overall","2011","2","0","1","0","3"
"National Endowment for the Humanities","Agency Overall","2011","0","0","0","1","1"
"Federal Trade Commission","Agency Overall","2011","17","5","2","1","25"
"United States African Development Foundation","Agency Overall","2011","0","0","0","0","0"
"Nuclear Regulatory Commission","Agency Overall","2011","8","2","0","4","14"
"Postal Regulatory Commission","Agency Overall","2011","0","0","0","0","0"
"Recovery Accountability and Transparency Board","Agency Overall","2011","0","0","0","0","0"
"Office of the Director of National Intelligence","Agency Overall","2011","2","0","0","1","3"
"Office of the Special Inspector General for Afghanistan Reconstruction","Agency Overall","2011","1","0","0","0","1"
"Environmental Protection Agency","Agency Overall","2011","77","27","49","55","208"
"Social Security Administration","Agency Overall","2011","27","7","66","0","100"
"Department of Labor","Agency Overall","2011","17","89","6","281","393"
"Federal Open Market Committee","Agency Overall","2011","1","0","0","0","1"
"Department of the Interior","Agency Overall","2011","28","11","44","147","230"
"National Science Foundation","Agency Overall","2011","15","2","2","2","21"
"United States Copyright Office","Agency Overall","2011","2","0","0","0","2"
"Consumer Product Safety Commission","Agency Overall","2011","12","2","1","6","21"
"United States International Boundary and Water Commission","Agency Overall","2011","1","1","0","0","2"
"All agencies","Agency Overall","2011","4640","1740","1516","2788","10684"